10x10
**********
**.......*
*........*
******...*
*........*
*****....*
*...*....*
*...*....*
*........*
**********
