10x10
**********
**.......*
*........*
*....*...*
*........*
*........*
*........*
*........*
*........*
**********
