5x5
*****
**..*
*...*
*...*
*****
